way
16x16
0,10;0
15,1;-1
14,1;-1
13,1;-1
13,13;-1
13,12;-1
13,11;-1
13,10;-1
13,9;-1
13,8;-1
13,7;-1
13,6;-1
13,5;-1
13,4;-1
13,3;-1
13,2;-1
12,13;-1
11,13;-1
10,13;-1
9,13;-1
8,13;-1
7,13;-1
6,13;-1
6,12;-1
6,11;-1
6,10;-1
6,9;-1
6,8;-1
5,8;-1
4,8;-1
3,8;-1
2,8;-1
1,8;-1
0,8;-1
5,5;-1
4,5;-1
3,5;-1
2,5;-1
1,5;-1
0,5;-1
5,4;-1
5,3;-1
8,2;-1
7,2;-1
6,2;-1
5,2;-1
8,4;-1
8,3;-1
12,5;-1
11,5;-1
10,5;-1
9,5;-1
8,5;-1
10,10;-1
10,9;-1
10,8;-1
10,7;-1
10,6;-1